11111111111111111111
100000000000000000E1
10001111111000111001
1C001000010001000001
10001110101110111001
100000100010000100C1
10111110001111110001
100000000000P0000001
1C0011111011111000C1
10001000010001000101
10001110111011100001
10000010001000100001
10111110001111110001
1C00000000C0000000C1
11111111111111111111